
#########             #########
#       ###############     # #
# #####               ### # # #
# ##### ############# ### # # #
#                     ### # # #
##################### ### # # #
#   ##                   # # #
# # ## ### ## ########### # # #
# #    #   ##B#           # # #
# ###### ################ # # #
###   ##             ##### # #
### ######## ########### # # #
###           ##         # # #
###### ###### ####### #### # #
###### ####               #  #
A      #######################
