#########             #########
#     #################     # #
# ###                 ### # # #
# ### ################### # # #
#                         # # #
######################### # # #
#   ##                   # # #
# # ## ### ## ########### # # #
# #    #   ##B#           # # #
# # ## ################## # # #
### ##              ##### # # #
### ############### ### # # # #
###              ##     # # # #
###### ######### ####### # # #
###### ####                # #
A      #######################
